0 0x400a10 0x400a52 
1 0x400b18 0x400b28 
2 0x400a58 0x400a64 
3 0x400a87 0x400aa7 
4 0x400a70 0x400a75 
5 0x400a7b 0x400a81 
6 0x400aa9 0x400aad 
7 0x400aaf 0x400ae5 
8 0x400ae7 0x400aea 
9 0x400aec 0x400b12 
