0 0x400bf0 0x400c34 
1 0x400cfe 0x400d0c 
2 0x400c3a 0x400c45 
3 0x400c63 0x400c86 
4 0x400c50 0x400c5d 
5 0x400c88 0x400c8d 
6 0x400c8f 0x400ce3 
7 0x400ce9 0x400d0c 
