0 0x400b30 0x400b54 
1 0x400bae 0x400bdf 
2 0x400b56 0x400b7a 
3 0x400ba4 0x400bac 
4 0x400b80 0x400ba2 
5 0x400be0 0x400be4 
6 0x400bc0 0x400bdf 
7 0x400b7c 0x400b7c 
