0 0x400ff0 0x400ff6 
1 0x401000 0x401006 
2 0x400ff8 0x400ff8 
3 0x401008 0x40100e 
4 0x401010 0x401026 
