0 0x400fb0 0x400fb6 
1 0x400fc0 0x400fc6 
2 0x400fb8 0x400fb8 
3 0x400fc8 0x400fce 
4 0x400fd0 0x400fe6 
