0 0x400d80 0x400dad 
1 0x400e56 0x400e5c 
2 0x400e19 0x400e4c 
3 0x400db3 0x400ddd 
4 0x400e0f 0x400e17 
5 0x400de8 0x400e0d 
6 0x400e50 0x400e54 
7 0x400e2b 0x400e4c 
8 0x400ddf 0x400ddf 
