0 0x400c60 0x400ca2 
1 0x400d68 0x400d78 
2 0x400ca8 0x400cb4 
3 0x400cd7 0x400cf7 
4 0x400cc0 0x400cc5 
5 0x400ccb 0x400cd1 
6 0x400cf9 0x400cfd 
7 0x400cff 0x400d35 
8 0x400d37 0x400d3a 
9 0x400d3c 0x400d62 
