0 0x4008c0 0x4008ea 
1 0x40093d 0x400949 
2 0x4008ec 0x400902 
3 0x400950 0x40096c 
4 0x400904 0x400918 
5 0x40091a 0x400949 
