0 0x4009d0 0x400a5f 
1 0x400a88 0x400ae4 
2 0x400b90 0x400b9a 
3 0x400a61 0x400a6f 
4 0x400a75 0x400a83 
5 0x400aea 0x400aef 
6 0x400b11 0x400b19 
7 0x400af8 0x400b0b 
8 0x400b1b 0x400b88 
