0 0x400e60 0x400ea4 
1 0x400f6e 0x400f7c 
2 0x400eaa 0x400eb5 
3 0x400ed3 0x400ef6 
4 0x400ec0 0x400ecd 
5 0x400ef8 0x400efd 
6 0x400eff 0x400f53 
7 0x400f59 0x400f7c 
