0 0x400640 0x400671 
1 0x4006cf 0x4006e0 
2 0x400673 0x40068a 
3 0x4006e1 0x4006f2 
4 0x40068c 0x400699 
5 0x4006c9 0x4006e0 
6 0x40069b 0x4006a4 
7 0x4006b7 0x4006c7 
8 0x4006b0 0x4006c7 
