0 0x400700 0x400732 
1 0x40076f 0x400781 
2 0x400738 0x400781 
3 0x400783 0x400793 
4 0x400795 0x4007a1 
