0 0x400cf0 0x400d3c 
1 0x400db5 0x400dc6 
2 0x400d4b 0x400d53 
3 0x400d5f 0x400d6b 
4 0x400d58 0x400d5d 
5 0x400db0 0x400dc6 
6 0x400d6d 0x400da0 
7 0x400da2 0x400dac 
8 0x400d3e 0x400d53 
