0 0x400af0 0x400b28 
1 0x400b46 0x400b54 
2 0x400b30 0x400b44 
3 0x400b68 0x400b74 
4 0x400b56 0x400b60 
5 0x400b2a 0x400b2a 
