0 0x400b80 0x400bae 
1 0x400c19 0x400c31 
2 0x400bb0 0x400bc1 
3 0x400be9 0x400bff 
4 0x400bc8 0x400be7 
5 0x400c32 0x400c69 
6 0x400c01 0x400c17 
7 0x400c08 0x400c17 
