0 0x400670 0x4006a2 
1 0x4006df 0x4006f1 
2 0x4006a8 0x4006f1 
3 0x4006f3 0x400703 
4 0x400705 0x400711 
