0 0x400b60 0x400b87 
1 0x400bf3 0x400c25 
2 0x400b89 0x400bb4 
3 0x400be9 0x400bf1 
4 0x400bc0 0x400be7 
5 0x400c30 0x400c34 
6 0x400c05 0x400c25 
7 0x400bb6 0x400bb6 
