0 0x400c40 0x400c82 
1 0x400d3f 0x400d4d 
2 0x400c88 0x400c91 
3 0x400cac 0x400cd1 
4 0x400c98 0x400ca6 
5 0x400cd3 0x400cd8 
6 0x400cda 0x400d24 
7 0x400d2a 0x400d4d 
