0 0x400a50 0x400a93 
1 0x400ab7 0x400ad6 
2 0x400aa0 0x400aa5 
3 0x400b40 0x400b50 
4 0x400aab 0x400ab1 
5 0x400ad8 0x400adc 
6 0x400ade 0x400b0e 
7 0x400b10 0x400b14 
8 0x400b16 0x400b3c 
9 0x400a95 0x400a95 
